10/2
1111121111
1111111111
1111111111
1111121111
1111121111
2221121122
1111111111
1111111111
1111111111
1111241111
/
0000000000
0000000000
0000000000
0000000000
7777777777
2221111122
1111111112
1111111111
2111111111
2211171111