10/3
1111121111
1111111111
1111111111
1111121111
1111121111
2221121122
1111111112
3111111115
2111111111
2411111111
/
0000711111
0000711111
0000711111
0000711111
7777711111
1111121122
1111121111
7111111117
1111111111
1711121162
/
0000000000
0000000000
0000000000
0000000000
0000777777
0000711111
0000711111
0000711111
0000711111
0000711171